2 - GRASS
4 - ROCK

#Map 16 11
0 0 0 0 0 0 0 0 0 0 0 0 0 0 0 0
0 0 0 0 0 0 1 1 1 1 1 1 0 0 0 0
0 0 0 0 1 1 1 1 1 1 1 4 1 1 0 0
0 0 0 0 1 4 1 1 1 1 1 1 1 1 0 0
0 1 1 1 4 1 1 1 4 1 1 1 1 1 0 0
0 1 1 1 1 1 1 1 1 1 4 1 1 1 0 0
0 1 1 1 2 1 1 6 1 1 1 1 1 1 0 0
0 1 4 1 1 1 1 1 1 1 1 1 4 1 0 0
0 1 1 1 1 1 1 1 1 1 1 1 1 0 0 0 
0 0 0 0 1 1 1 1 1 1 1 1 0 0 0 0
0 0 0 0 0 0 1 1 1 0 0 0 0 0 0 0
0 0 0 0 0 0 0 0 0 0 0 0 0 0 0 0